HHHHHHHHHHHHHHHHHHHTT
HHHHHHHHHHHHHHHHHHTTH
HHHHHHHHHHHHHHHHHTTTH
HHHHHHHHHHHHHHHTTTTHH
HHHHHHHHHHHHHHTTTHHHH
HHHHHHHHHHTTTTTHHHHHH
HHHHHHHHHTTEETTHHHHHH
HHHHHHHHTTEEEETTHHHHH
HHHHHHHTTEEEEEETTHHHH
HHHHHHHTEEEEEEEETHHHH
HHHHHHHTEEEEEEEETHHHH
HHHHHHHTTEEEEEETTHHHH
HHHTTHHHTTEEEETTHHHHH
HHTTTTHHHTTEETTHHHHHH
TTTHHTTTHTTTTTTHHHHHH
TTHHHHHTTHHTTTHHHHHHH
HHHHHHHTTTTTTHHHHHHHH
HHHHHHHHTTTHHHHHHHHHH
HHHHHHHHHHHHHHHHHHHHH
HHHHHHHHHHHHHHHHHHHHH