HHHHHHHHHHHHHHHHHHHHHHHHH
HHHHHHHHHHHHHHHHHTTTTTTTT
HHHHHHHHHHHHHHHHTTTTTTTTT
HHHHHHHHHHHHHHTTTTHHHHHHH
HHHHHHHHHHHHHTTTHHHHHHHHH
HHHHHHHHHTTTTTHHHHHHHHHHH
HHHHHHHHTTEETTHHHHHHHHHHH
HHHHHHHTTEEEETTHHHHHHHHHH
HHHHHHTTEEEEEETTHHHHHHHHH
HHHHHHTEEEEEEEETHHHHHHHHH
HHHHHHTEEEEEEEETHHHHHHHHH
HHHHHHTTEEEEEETTHHHHHHHHH
HHHHHHTTTEEEETTHHHHHHHHHH
HHHHHHHHTTEETTHHHHHHHHHHH
TTTTTTTHTTTTTTHHHHHHHHHHH
THHHHHTTHHTTTHHHHHHHHHHHH
HHHHHHTTTTTTHHHHHHHHHHHHH
HHHHHHHTTTHHHHHHHHHHHHHHH
HHHHHHHHHHHHHHHHHHHHHHHHH
HHHHHHHHHHHHHHHHHHHHHHHHH