HHHHHHHHHHHHHHHHHHTT
HHHHHHHHHHHHHHHHHTTH
HHHHHHHHHHHHHHHHTTTH
HHHHHHHHHHHHHHTTTTHH
HHHHHHHHHHHHHTTTHHHH
HHHHHHHHHTTTTTHHHHHH
HHHHHHHHTTEETTHHHHHH
HHHHHHHTTEEEETTHHHHH
HHHHHHTTEEEEEETTHHHH
HHHHHHTEEEEEEEETHHHH
HHHHHHTEEEEEEEETHHHH
HHHHHHTTEEEEEETTHHHH
HHHHHHTTTEEEETTHHHHH
HHHHHHHHTTEETTHHHHHH
TTTTTTTHTTTTTTHHHHHH
THHHHHTTHHTTTHHHHHHH
HHHHHHTTTTTTHHHHHHHH
HHHHHHHTTTHHHHHHHHHH
HHHHHHHHHHHHHHHHHHHH
HHHHHHHHHHHHHHHHHHHH