CCCCCCCCTCCCCC
CCCCCCCCTCCCCC
CCCCCCCCTCCCCC
CCCCCCTTTCCCCC
CCCCCCTCCCCCCC
CCCCCCTCCCCCCC
TTTTTTTTTTTTTT
CCCCCTCCCCCCCT
CCCCCTCCCCCCCT
CCCCCTCCTTTTTT
CCCCCTCCTCCCCC
CCCCCTTTTCCCCC
CCCCCTCCCCCCCC
CCCCCTCCCCCCCC

XXAAAXXXXXXXXX
XXAAAXXXXXXXXX
XXAAAXXXXXXXXX
XXXAXXXXXAAAXX
XXXAXXXXXAAAXX
XXXXXXXXXAAAXX
XXXXXXXXXXAXXX
XAAAXXXXXXAXXX
XAAAXXXXXXXXXX
XAAAXXXXXXXXXX
XXAXXXXXXXXXXX
XXAXXXXXXXXXXX
XXXXXXXXXXXXXX
XXXXXXXXXXXXXX